type octile
height 10
width 10
map
TTTTTTTTTT
T.....s.TT
T.TTTTTTTT
T........T
T.T.TT..TT
T.T......T
T.T.TTTTTT
T.......TT
TTT.T.TTTT
TTTTTeTTTT